111111111111
1FIV1...2..1
11111...5..1
1MIY1......1
111111111111
