111111111111
1FIS1..F...1
11111...I2.1
1MIY1..P5..1
1..........1
111111111111
